13th Column - As Death Takes All
7th Nemesis - Deterministic Nonperiodic Flow
A Distorted Utopia - Sleepless Walks
A Vulgar Picture - The World I Found
Aberratio - Aberratio (320)
Abitabyss - Requiem Du Secteur Primaire
Abominant - Conquest
Abominant - The Way After
Aborted Fetus - Fetal Embalmed Existence 
Abortion - The Gonzo Music
Absolute Darkness - Disaster Awaits
Abysmal Dawn - Leveling the Plane of Existence (Instrumentals)
Abyssal Ascendant - Chronicles of the Doomed Worlds, Pt. 2: Deacons of Abhorrence (320)
Accidental Death Benefit - Венец Творения Природы
Aceldama - Cruciatti Mentis
Acrania - Fearless
Acromizer - Spreading The Plague
Act Of God - Kaosism
Acéldama - Essence of Impurity
Adam Abou-Gad - Roots of Perdition, Volume 1: Declension
Adimiron - Et Liber Eris
Advent of Bedlam - Human Portal Phenomenon
Aeon Patronist - Through The Paths of Delusion
Aeternus Prophet - Exclusion Of Non-Dominated Material
After Oblivion - Stamina
Ageless Oblivion - Temples of Transcendent Evolution (320)
Agonize - Chaos Reborn
Alchemist - Austral Alien
Aletheian - Apolutrosis
Aletheian - Dying Vine
Alexander Oden - The Culmination
Alice Through The Windshield Glass - Brutalis Australis
All Is At An End - Brutal Nature 
Allegiance - Blodörnsoffer
Allegiance - Hymn Till Hangagud
Allegiance - Vrede
Amethyste - Thrown Off Balance
Ammonium - Erased Existence
Anal Vomit - Peste Negra, Muerte Negra
Anam - Genesis
Ancient Hymns - From Chaos 
Ancress - Victoria/Jeiunium 
Angel Of Disease - Hypercube
Angerot - The Divine Apostate (Inverted Edition)
Anime Torment - Afterlife
Annihilator - For The Demented
Annihilus Mundi - Grief
Anti Flesh Nimbus - Das 2. Siegel
Antidemon - Apocalypsenow
Antigama - Meteor
Antigama - Resonance
Aparia - Beyond the Walls of Man
Apokalyptic Raids - Only Death Is Real...
Apparatus - Yonder Yawns the Universe
Ara - Devourer of Worlds
Aravt - Nuudliin Daichid
Ars Notoria - Chronicles
Ascending Olympus - Frontlines
Ashen - This World is Not Ours
Asilian - Escarcération
Aspatra - Aspatra
Asphalt Graves - The New Primitive (RE 2019)
Atheretic - Apocalytic Nature Fury
Atomwinter - Atomic Death Metal 
Atomwinter - Iron Flesh
Atomçk - Every Room In Britain
Atra Mustum - Хаос
Autopsy - Acts Of The Unspeakable (RM 2003)
Awful Noise - A Peaceful Death With Pretty Flowers
Azure Emote - Chronicles Of An Aginig Mammal
BUM - 1‰
Barathrum - Okkult
Barathrum - Venomous
Barbaric Penetration - Graveyard Hunt for Carnal Pleasure EIT - 002 ( Sold Out )
Barracuda - Humanimal
Barrows - Swine Race
Bear Mace - Charred Field of Slaughter 
Bearstorm - Americanus
Beastplague - A Different Animal
Beheaded Zombie - Счастье Для Всех
Beheading Machine - Narcobiological Upgrade
Behemoth - Blow Your Trumpets Gabriel [Single]
Behold the Slitted Carcass - Divine Hypothetical Self-Contained Plane of Existence
Belphegor - Blutsabbath (Remastered 2021)
Belphegor - The Last Supper (Remastered 2021)
Bestial Sight - When You Need Metal...Go to Hell 
Betrayed Heaven - Paradox
Beyond Belief - Towards the Diabolical Experiment (RM 2016)
Beyond Grace - Seekers
Big Sleeping Lavaman - The Adversary
Birdflesh - Night Of The Ultimate Mosh
Bitter Peace - Ashes of Oppression
Bittered - Foreign Agenda
Black Bleeding - A Bright Future
Black Fast - Terms Of Surrender
Blackdwarf - Mankind Eternal Dilemma
Blackhorned Saga - Lathspell
Blasphemer - The Sixth Hour (320)
Blasphemous Creation - The Rise Of Marduk
Blast Perversion - Female Massacre
Blast Perversion - Portals of Perversion
Blood - Dysangelium
Blood Coven - To Ascend from Blackened Realms
Blood Vengeance - Iron Warfare
Blood of Raui'Ahn - Holographic Eulogy
Blood on the Scales - The Human Condition
Bloodfeast - Mea Culpa
Bloodrainbow - Upheaval
Blumpkin Spice Latte - Horrific Nature
Boarcorpse - Boarcorpse/Composted/Scaphism Split
Bonebreaker - Hell's Bullets
Boneyard - Return to a Zombie Planet
Bookakee - Whorrific
Brain Disorder - The Massive Killing
Breed of Bacchus - Liberalia
Broken Flesh - Broken Flesh
Brutal Dog - Inferno
Buckshot Facelift - Elder's Rasp
Buffalo Grillz - Manzo Criminale
Buffalo Grillz - Martin Burger King
Bunk Dope - Sores (320)
Buried Dreams - Beyond Your Mind
Buried Realm - Embodiment of the Divine
Bästard - Dementia and Filth 
CROSS GNAWER - UNDER THE CATACOMBS
Cadaver Cum - Horrifying Repugnance
Cadaveric Crematorium - Serial Grinder
Cadejo - Nuestras Raíces
Calm Hatchery - Fading Reliefs
Cancer Priest - Weaponized Brainstem
Carbonized Gnawing Mandible - Anointed by the Elders
Cardiac - Deformation
Caress - Return To The Hospital
Carignan - Mastubatorium
Carnage - Carnage's Ceremony
Carnage - The Stench of Rotting Souls
Carrioned - Echoes Of Abomination
Catacombs - Materialized in Agony
Catarsis Incarne - Abiogénesis, Libro III
Catholicon - Of Ages Past
Cauldron Black Ram - Slaver
Cauldron Burial - Orgia Nocturna
Cavil - Cavil
Centaurus-A - Means of Escape
Centenary - Into The Graveless Beyond
Cerebral Depravity - Decades of Suffering 
Cerebral Engorgement - Cerebral Chronicles
Cerebrum - Iridium
Ceremony - Retribution
Chaos Synopsis - Gods of Chaos (Brazilian Limited Edition)
Chaosfury - The Throne of Poseidon
Chaotic Christ - Umbilicorpse
Chronic Ashes - Cursed Existence (320)
Churchacide - Subversive Declarations
City - On The Edge Of Forever
Clandestine Revelation - Desecrated Existence
Clandestine Revelation - Desecrated Existence (EP)
Cloudburst - Cloudburst
Cobalt 60 - The Grim Defiance
Coffin Rot - A Monument to the Dead 
Condemn the Infected - Deny Existence
Conquering Dystopia - Conquering Dystopia
Consumned - Manipulation
Coprolith - Cold Grief Relief
Coprolith - Death March
Corpse Grinder - Into the Coffin
Cortege - Vandari
Cote d'Aver - Proboscis Strangulation
Crest Of Darkness - Give Us The Power To Do Your Evil
Crest Of Darkness - In The Presence Of Death
Crest Of Darkness - The God of Flesh
Crest of Darkness - Sinister Scenario
Cretin - Freakery
Criterion - The Dominant
Critical Mess - Man Made Machine Made Man
Cromlech - A Deep Dark Dream
Crooked God - Cruel and Blasphemous
Crowbar - The Serpent Only Lies
Crucifyre - Post Vulcanic Black
Crummer - Deathwards 
Crurifragium - Beasts of the Temple of Satan
Cryogenic Implosion - Creation of the new world
Cryptobiosis - Chainsaw Crucifixion - Instrumental Torture
Cryptophilia - Confection of Morbidity - Final/ Mastered
Cuentos De Los Hermanos Grind - El Tesoro Del Placer
Cult Of Occult - HIC EST DOMUS DIABOLI
Culture Killer - Skingluedshut
Cunt Cuntly - Agoraphobia
Curse of Denial - Coming for Your Soul
Cyaxares - Whores of Babylon (320)
DEEP DIRTY - COOPERATION SONGS
DNO - Do Not Open
Dakhma - Hamkar Atonement
Damnation - Fátum
Damnation Defaced - Invader from Beyond
Dargonomel - Rebelliant Daemonis
Dark Fortress - Profane Genocidal Creations
Dark Funeral - Diabolis Interium 
Dark Remains - A Construct To Obliterate
Darkmoon - Apocalyptic Syndrome
Darkmoon - Decline
Daybreak - Empty Earth
Daylight Dies - Dismantling Devotion
Daylight Dies - Lost To The Living
Dead Alone - Ad Infinitum
Deadringer - Realidad De Mortalidad
Death Dimensions - Ancient
Death Level - The Era Of Religion's Demise
Death Metal Rabbits - 20 Songs of Happiness
Death Upon the Ignorant feat. Kieran York - Call of the Void
Deathening - Antifascist Death Metal
Decapitado - La Pesadilla Apenas Comienza...
Decasion - Instilling the Decayed Obsession
Deceptive Incarnation - The Last Revelation of a Dying Breed
Decomposition Of Entrails - Abnormality (Instrumental Edition)
Decomposition Of Entrails - Abnormality (Instrumental Edition)Dark Fortress - Tales from Eternal Dusk
Decomposition Of Entrails - Pestilential Synthesis
Defamer - Decrepit Rituals
Defcon One - The Perfection Of Slavery
Defenestrator - Defenestrator
Defiled Crypt - Convoluted Tombs of Obscenity 
Deflowered - Infestation Begins...
Deformity - Spiritual Genocide 
Dehydrated - Sickness (Single)
Dei Aemeth - Apotheosis
Denouncement Pyre - Black Sun Unbound
Denouncement Pyre - Forever Burning
Depraved - Raped Innocence
Depraved - Sexual Depravity… And Pleasure To Suffer
Desecrated Dreams - Die!mensions
Desecrated Dreams - Feelings Of Guilt
Desecration - Gore and Perversion 2
Deserted Fear - Drowned By Humanity
Despondent - Tales of Insanity
Destinity - In Excelsis Dementia
Destinity - Synthetic Existence
Destinity - The Inside
Destroyer Attack - Ominous Devotion
Detest - Sacred Revelation
Detest - Sacred Revelation 
Detrimentum - Inhuman Disgrace
Deus Otiosus - Godless
Devils Drunks - Devils Drunks
Devoured - The Curse of Sabda Palon 
Devourer - Dawn of Extinction
Devourer - Raptus
Devouring Cadavers - Feast Of Blood
Devourment - Butcher The Weak (Re-recorded)
Diabetic Ketoacidosis - Endoscopic Retrograde Cholangiopancreatography
Diabolic - Blastmasters Twisted Metal
Diabolicon - Infernal Prophecy
Diary About My Nightmares - Forbidden Anger
Dimension Shifter - Survive/Suffer
Dimension Strength - Álbum desconocido (04/04/2023 11:14:54 p. m.)
Dimensional Fatality - Summoning Anime Girls to Shred
Diocletian - Amongst the Flames of a Burning God
Diocletian - Doom Cult
Discovery Through Torment - The Mangled God
Discreation - Iron Times
Disembowel - Sacraments of Torture and Spiritual Desecration
Disgust - Infinite Obliteration
Disheveled Convolution - Disheveled Convolution
Dishonour The Crown - The English Way
Disillumination - Into the Darkness of the Eternal Word
Disintegration - Prahara 
Display Of Decay - Dust Of Existence
Dispyt - Den ständigt närvarande ångesten
Doombringer - The Grand Sabbath
Doprdele - DoprdeLeS'
Dragonlord - Dominion
Dripback - Failed Futures
Dropkik - Blight and Betrayal
Drowned In Blood - Underworld
Dwelling Bellow - Dwelling Bellow
Dying Signals - Intuitive Senses
Dysphotic - The Eternal Throne
Déhà - How To Despise Humanity In 7 Lessons And A Half
EQUINOXIO - Ritos Abominables
Earth Rot - Follow The Black Smoke
Ebony Sorrow - Withered Monuments Of A Fractured Utopia
Echidna - All Dead
Ectomy - Время и Вечность
Edenbeast - Torturing The Odd Human Mind
Embodied - Perception Perverse
Eminenz - Nemesis Noctura
Encircle - Lost Chronicles
End Of Salvation - Monolith Of Leviathan
Endemic - The Church of Destruction
Endless - The Seventh Revelation
Endless Affliction - Savage Retribution
Endless Curse - Drink, Smoke and Don't Give a Fuck
Endless Distrust - Collateral Damage
Endless Fear - The Witch
Enemy Reign - Between Hell and Oblivion
Engorgerectomy - 725
Enterprise Earth - Luciferous
Entrenched Ingurgitation - Genesis Of Heterogeneous
Entropy - Blood Opus
Epicedium - Intoxicated Intercourse
Epicenter - Subversion
Equestria Metallers - Feel the Harmony
Eradication of the Unworthy Infants - Change is Good
Erebos - Descent to Beyond
Erectus - Decimation
Erimha - Thesis Ov Warfare
Eroded Ashes - Out For A Hunt
Errance - II
ErrorGod - Ballad of Torture 
Errorgeist - Agendas Elite
Eternal Tragedy - Forever
Evil Warriors - Expressions Of Endless Dreams
Evoked - Ravenous Compulsion
Exaleips - The End Amenities and The Beginning of Deranged Suffering
Execution - Contrast (320)
Exhausted Prayer - Ruined
Exsanguination Throne - At the Inside of the Darkness (320)
Extinctionist - World Extinction
Extreme - Technological Death
Fadihat - Family Mortuary Cannibalism
Faeces - Upstream
FamishGod - Devourers of Light 
Fecalizer - (De)Composing the System
Feraliminal Lycanthropizer - Anal Conception of the Dominant Female
Feretral - Cataclysmic Oppositors Vomiting Iconoclastic Diseases
Festival Of Mutilation - Gods Of Infernal Desolation
Fetus Fucker - Hung, Desecrated, And Mutilated The Plague-Ridden Fetus
Fetus Grinder - Terror In The Women's Clinic
Fetus Slicer - Metamorphoses of Sickness
Filial Cannibalism - Guttural Congregation
Fit For An Autopsy - The Great Collapse (Rain City Deluxe Version)
Flagellation - First Step To Armageddon
Flesh Grinder - Coroner's Inquest Suit
Flesh Hoarder - Relic of Putrescent Filth
Flesh Incineration - Nescient Atrophy
Forced Asphyxiation - Terrifying Hydroponic Carnage
Forensick - Reingn Of Survival Horror
Forgotten Silence - La Grande Bouffe
Fornicator - Fornicator
Fornicus - Storming Heaven
Fractal Reality - A Plague For Eternity
Fractalline - Polymath Theory
Freakhate - It Comes from the Grave
From Beyond Death - Exhibit A
Front - Iron Overkill
Fuck Shit Up - Generation Of Defecation
Fuck The Facts - Disgorge Mexico
Funeral Inception - H.A.T.E.
Funeral Mist - Maranatha
Gangrena - Oscuro Tormento 
Gangrena Febrosa - Surgical Abominations Medical
Garroter - Corporal Punishment
Gate - Resurrection Of Relentless God
Genocide Generator - I
Genre: Unknown
Gethebong - Genocide
Ghamorean - Plague Empire
Gilded Lily - Mongrel's Light
Gloom - Solaris
Gloria Morti - Lifestream Corrosion
Gluttony - Drogulus
God Defamer - Relics
Godless - Ecce Homo: Post Lux Tenebras, Pulsio XIII Ultima Ratio
Godslut - Procreation of God
Godtoth - Satanic Holocaust
Gomory - My Throne
Gonoba - Chains Of Ignorance
Goodnight Irene - Tyrant
Gore Massacre - Gore
Gore Of War - Foibe
Gore Penetration - Fetish Concept
Goreskin Coffin  - Corpse Filled Caskets
Gorestorm - Dissimilitude
Gorguts - The Erosion of Sanity (RM 2006)
Gory Blister - Reborn from Hatred
Gosudar - Morbid Despotic Ritual (320)
Granulocytic Blastoma - Moments Of Tarsotomy
Gravehuffer - Blasphemusic
Gravewürm - Doomed To Eternity
Grey Heaven Fall - Черная Мудрость
Grief of Emerald - Christian Termination
Grind Inc. - Inhale The Violence
Grisly - Tomb King
Gross Misconduct - Equinox
Gruesome Fate - Repugnant Dissertation Of Necrosis
Hacavitz - Nex Nihil
HackxWhore - Keeping It Stiff
Hadal Maw - Olm
Handful of Hate - To Perdition
Hands Of Thieves - Feasting On Dark Intentions
Harvest The Murdered - Requiem For A Millenium
Hate Force - Hate Force
Haunter - Thrinodía (Remixed & Remastered 2020)
Havok - Being And Nothingness
Haxen - Haxen
HeadShot - Self Destruct
Hekseri - Hekseri
Hell-Born - Hellblast
Hell-Born - Legacy Of The Nephilim
Hellbomb - Hellbomb
Hellfire - Thirty Five Stairs
Herrementari - Exterminate and Dominate
Hierarchy - Hierarchy
Hierophant - Peste
Hirilorn - Legends Of Evil And Eternal Death
Homicide - Minotaur Unleashed
Homophobic Fecalpheliac - Sadistic Thoughts Of A Serial Killer
Horned Almighty - To Fathom the Master's Grand Design
Hornwood Fell - Cursed Thoughts - Part I
Horror God - Planet of Ruins
Hot Graves - Magnificent Death
Hukutus - Oksitosiini
Human Infection - Infest To Ingest
Hunting the Beast - When Night Falls...
Hura Crepitans - Sandbox Tree
Hutt - Monstruario
Hypaethral - Hypaethral
INFINITE DENSITY - Recollapse of the Universe
Icethrone - Winter Tales
Ichor - Hadal Ascending
Idols - Choose Hate
Ignominious - The Throne and the Altar
Illdisposed - Reveal Your Soul for the Dead
Immortal Possession - The Resurrectionist
Immortal Suffering - Preyed Upon
Impending Doom - Baptized In Filth
Imperative Decreation - Imperative Decreation
In Hell - Satanica Mundi
In Shadows and Dust - A Fleur de Peau
In The Fire - The Living Horror Show
In Utero Cannibalism - Dehumanize
In Vain - The Latter Rain
Incarnator - Caeca Superstitio
Incordia - The Talon-Elder (320)
Indecent Excision - Deification Of The Grotesque
Inevitable End - The Oculus
Inevitable End - The Severed Inception
Inexorable - Imperious
Infamovs - Under the Seals of Death
Infection - The Cryptic Homicides
Infectology - Deification of Anthropophagical Rites
Infernal Sacrament - Militant Hyms of the Rebel Angel
Infernal Thorns - Inflicting Ravage to the Holy Cattle
Infernia - Antesala del Infierno
Infest - Addicted To Flesh
Infest - Everlasting Genocide
Infester - To The Depths, In Degradation + Darkness Unveiled [Reissue]
Infesticyde - Infesticyde
Infidel Reich - Reichenstein
Inner Sanctum - Legions Awake
Inoculated Life - Exist To Decay
Insane Assholes - Stralci Di Oblio
Insanity - Death After Death
Internal Bleeding - Voracious Contempt
Invokaos - Retirantes do Holocausto
Iria - Pagan Terror
Irritate - Everyday Evil
Isacaarum - Retrorgy (320)
Isolated - Ungodly Abomination 
IиFested - Transcranial Micropolarization (320)
KHNVM - Visions of a Plague Ridden Sky
Kadaver Dolls - Machines Of Death
Kafirun - Eschaton
Kairos. - Simulgression
Kalibas - Rumors of Our Demise Have Been Barely Exaggerated (Watchmen Mix)
Kalmah - The Black Waltz
Kandarivas - Grind Surgical Shrine
Kaoteon - Damnatio Memoriae
Kaoteon - Kaoteon (320)
Kaoteon - Veni Vedi Vomui
Karras - We Poison Their Young
Khamûl - Hans Gítar
Khrophus - Eyes Of Madness
Kilhumanity - Killing
Killer Of Gods - Replica To Hell
Killgasm - A Stab In The Heart Of Christ
Knell - Zero Hour
Kommandant - Stormlegion
Kommandant - The Architects of Extermination
Kyterion - Inferno I
Landmine Marathon - Sovereign Descent
Lantern - II: Morphosis
Laparotomy - Ascendancy Through Hypnagogic Thought Process
Leishmaniasis - Chronicles of Her Atrocious Rotten-Obsessed Mind
Les Enfants Du Silence - Au Delà Du Songe
Lightning - Filthy Human Beings
Limbonic Art - A Legacy Of Evil
Limbonic Art - Spectre Abysm
Liquid Flesh - Dolores
Liquid Graveyard - By Nature So Perverse
Lock Horns  - Molṑn Labé
Loneshark - ...Or High Water
Los Criminis - Machete
Lost Brethren - The Forgotten Realm
Lucifericon - Al-Khem-Me
Lycanthropy - Hannibal Ante Portas
Lysithea - Realms
MARTIAL BARRAGE - Agents of the Wolf Age
Macabre Demise - Grave(y)art Gallery
Machina Baphometa - Shame of the Proud Angel
Malevolent - Gripping The Grinding Of Reality
Maleït - Maleïnt el Món
Malformity - Monumental Ruin 
Malignant Christ - Forever in Chaos
Malthusian - Across Deaths
Mangled - Mangled Beyond Recognition - Instrumental
Margg - Black Sun Rising
Markarth - Curse of Origins
Martin and The Vampires - Giving Head to the Living Dead
Martyrium - Ideology of Death
Maruta - Remain Dystopian
Mass Casualty - Death Count (320)
Mass Idolatry - Impure (320)
Mass Massacre - Repentance In Gangrene
Mass Murder - Extreme Extinction
Master Crow - Die For Humanity
Mechanism - Inspired Horrific
Menarca - Prognosi Infausta
Mental Cavity - Mass Rebel Infest
Mental Horror - Blemished Redemption
Mental Vortex - I Am Now​.​.​. Again
Mercy Brown - Mercy Brown [LP]
Miazma - North
Milking The Goatmachine - Goatgrind
Mindwork - Eterea
Minion - Pantera
Misanthrope - ΑXΩ (Alpha X Omega: Le Magistère De l'Abnégation)
Misanthropic Might - Feindt
Misanthropik Torment - Declaration Of War
Misanthropik Torment - Murder is My Remedy
Miscreation - AeOnd
Mithras - Behind The Shadows Lie Madness
Mithridatic - Miserable Miracle
Moltar - Chrysalis
Monoliyth - Imminent Demise
Montezuma - The Creation
Moonsorrow - Varjoina Kuljemme Kuolleiden Maassa
Moral Collapse - Divine Prosthetics
Mordenom - Agnvs Dei
Mordenom - Agnvs Dei 
More of Myself to Kill - Creation: A
Morgue - Artgore
Moribund Sun - Mental Torture
Morser - 1st class suicide
Mortals - Cursed To See The Future
Mortuary - Sublime the Decline
Mutilation Rites - Empyrean
Myrkskog - Deathmachine 
Mysthicon - Silva - Oculis - Corvi
NEURALECTOMY - Silent Valley Obituary
Naer Mataron - Lucitherion "Temple Of Radiant Sun"
Nalvage - Worship Dehumanization
Napalm Death - Harmony Corruption (RM 2012)
Napalm Death - Utopia Banished (Remastered 2012 Edition)
Nastergal - The Untold War
Nasty Surgeons - Anatomy Lessons
Natron - Grindermeister
Nattravnen - Kult Of The Raven
Nebulah - Down of Knowledge
Nebulous - The Quantum Transcendence Of Death
Necrodemon - Rise of the Supernatural
Necrolatry - Whinge
Necrophobic - Dawn of the Damned
Necrophobic - Dawn of the Damned 
Necropsy Defecation - Flesh Gore Pieces of Cannibalistic Ritual Altars
Necrovile - Engorging The Devourmental Void
Necrowar - All Trajectory
Nekroza - Procesija Ucrvanih
Nemoris - Esoteric Visions of the Old Ritual
Neverborn - 1000 Miles of Hell
Nihilo - Concordia Perpetua
Nistikko - Kehä
No Zodiac - Population Control
Noctem - Credo Certe Ne Cras
Nocturnal Bleed - Lake of Fire
North - Czekajac Na Sztorm
Norther - Mirror Of Madness
Not Beneath - Memento Mori
Nothing Lies Above - Liber Teth
Nyogthaeblisz - Abrahamic Godhead Besieged by Adversarial Usurpation
Obastra - Mosaic
Obituary - Cause of Death (1998 remastered)
Obnoxious - Extinction
Obnoxious - Lab#01
Obscene Eulogy - Defining Hate - The Truth Undead
Occult - Rage To Revenge
Occult Burial - Burning Eerie Lore
Odem - Timeless Past Above
Odetosun - The Dark Dunes of Titan
Odin's Court - Reign of Olympus
Odyssian - Olde
Oerjgrinder - Grind My Bith Up
Okkultation - The Cryptic Manuscript
Okult - Signum Diabolica
Ominous Gatekeeper - Six Miles Down The Well
Omniarch - Omniarch
Omnizide - Death Metal Holocaust
Ontogeny - Hymns Of Ahriman
Orcus Patera - Schattenmarsch
Ordeathral - A Cell Made of Chalk, Coal and Blood
Order From Chaos - Stillbirth Machine
Organ Harvest - Bowel Waltz
Organic Infest - The Way to Temptation
Orki - Orki
Orphan Stomper - Orphan Stomper
Os Capial - Emboscada Caipira de Plasma
Ossuary Anex - Awakening
Otargos - No God, No Satan
Outlaw - Path to Darkness
Overnoise - Lethal Ways To Hell's Kitchen Doors
Pain Patterns - The Dawn Collective
Painkiller - Death Carrier
Panzergod - Deathshrouds Bestowed
Parafilia Grotesca - Obscenidades Extrañas
Paranoid Despire - Nebulous
Parricide - Just Five
PartyGrind - Circo dos Horrores
Perdition Winds - Aura of Suffering
Perfecitizen - Humanipulation (320)
Perfecitizen - Through
Perverse Imagery - Abstract Melodies
Perversity - In the Garment of Lust
Philip H. Anselmo & The Illegals - Choosing Mental Illness As A Virtue
Pit of Blood - Spawn of Abomination (320)
Planet Hell - Mission One
Possessed Entity - Extermination Of Angelic Parasites
Postumo Lumbre - Empirikkal
Precipitation - The Power Of...
Profundi - The Omega Rising
Prohibitory - Battle Hymns From The Serpent Land
Prophecy Of Doom - Acknowledge The Confusion Master [Reissue] (2022)
Protest - Abuse of Power
Pseudonaja - Systemic Decomposition
Pseudostratiffied Epithelium - Into the Flames 
Psicovomitosis Sadinecrootitis - Sexlicioso
Psychopathic Rage - Fight! Kill! Win!
Psycophobia - Reality of a Psychotic Underworld
Psycroptic - As the Kingdom Drowns
Pungent Stench - "Club Mondo Bizarre" - For Members Only
Pungent Stench - Masters Of Moral - Servants Of Sin
Punish - Dawn of the Martyr
Punish - Sublunar Chaos
Punished Earth - Corporate Dictatory
Pure - Hell on Earth
Putrefuck - Repugnant Reality
Putrid Fate - Visions of Horror
Qishash - Unseen Truth
Queiron - Templars Beholding Failures
Queiron - The Shepherd of Tophet
Quetzalqoatl - Relación de las cosas de Yukatán
Radement - The Swarm
Rainwill - Canvas
Range Of Mutilated - Post Traumatic Perish
Rape Festival - Rape Festival
Rapture - Perpetual Transgression
Raspatory - Pathopsychology (320)
RazorRape - Fucked Beyond Recognition
Re-Armed - Rottendam
Realm Of Carnivora - Vikati Vari Te Palgel, Saabub Aeg Ja Teras Langeb... Vengeance Shall Come !!!
Recueil Morbide - Waste of Senses
Red Horizons - Angelic
Reincarnation - Seed Of Hate [Reissue] (2015)
Renascent - Praise of the Lord God Almighty
Repugnancia - Ritos de Interminable Agonia
Resuscitated - Inches from Death 
Reticulate - The Lungs of Depravation
Rev 16:8 - Grand Tidal Rave
Revel Decay - Eternal Decay
Revenge - Global Suffering Disease
Ritual of Flesh - Ritual of Flesh (320)
Rotten Penetration - Horrorous State Of Anatomical Decomposition
Rotten Poodle - Animal Supremacy
Round Up Ultra - The Seeds
Rudra - The Aryan Crusade
SHACKLΣS - HATREDS RESERVOIR
Sacrificial Blood - SoulS for Sale
Sacrificium - Escaping the Stupor (VBR)
Sad - Abandoned And Forgotten
Sadism - Summon
Sadistic Hallucinations - Atrocious Retaliation
Sanity In Death - Sanity In Death
Sapientia - Circulata Mercurius
Savagery - Cataclysmic Genocide
Scent Of Death - Woven in the Book of Hate
Sclera - Impaled Visions
Scolopendra - Cycles
Sculpting Atrocity - Ambiguous Deity Obscurus
Sear - Lamentations of Destruction 
Sedlec Ossuary - Machine Born
Sekhmet - Words Of The Master (Proverbs Of Hell)
Sending Artax -  Circus Of Me
Separatist - Closure
Separatist - The Motionless Apocalypse
Septic Agressor - Crush the Church Mims
Septicem - Pleasures of War
Septory - World War Chaos
Serpent Noir - Death Clan OD
Serpent Throne - Beyond the Chains of Decadence 
Sever the King  - Outbreak 
Sex Murder Art - The Human Sickness
Sexcrement - Genitales From The Porno Potty
Shades Of Mourning - In Your Image
Shattered Reality - Into the Abyss
Shores Of Elysium - The Arbiter's Clockwork
Shrine of Insanabilis - Vast Vortex Litanies
ShutUp - Made in Sweden (320)
Siaskel - Haruwen Airen
Siaskel - Jatenentopen Thejin
Sicarius - God of Dead Roots
Sickening Horror - When Landscapes Bled Backwards
Silent On Fifth Street - Embodied Cognition
Sinsaenum - Repulsion for Humanity
Sisters Of Suffocation - Eradication
Skeleton Rose - Kingdom
Skinned - Spawn Of Insanity
Sleep Terror - Unihemispheria
Slutvomit - Swarming Darkness
Smouldering in Forgotten - Invictus Mortem 
Snakepit - Eternal Conlfagration
Socavón - Pasos En Sangre
Solace of Requiem - Utopia Reborn
Sorrow - Hatred and Disgust
Sothoros - Flood The Stone
Soul Rape - Endless Reign
Soulgate - Sore
Soulphureus - Rest in Hell
Sparganum Proliferum - Parasitic Mutated Infecting Of Human Beings
Spasm - Split
Spazmosity - Welcome Death
Spearhead - Pacifism Is Cowardice
Spectral Souls - Towards Extinction
Spectres - Ghosts of Revolution
Spell Of Niriti - Watch Under Your Bed
Spineless Fuckers  - Piggy Puppies
Spires - Spiral Of Ascension
Splatta Fish - Celestial Plague
Splattered Entrails - Nauseate (320)
Split The Abyss - These Terrible Depths
Sprengkopf - Sprengkopf
Starring Janet Leigh - Spectrum
Stass - Songs of Flesh and Decay 
Static Abyss - Labyrinth of Veins
Suffering Quota - Collide
Suffersystem - The Mutilated One
Suhrim - Old Scars Fresh Wounds
Survive the Demise - Born of Slaughter
Svart Crown - Ages of Decay
Symbyosis - On The Wings Of Phoenix
Symphony of Heaven - The Season of Death
Synapse Defect - Conspiracy to Overthrow...
Synergic Ire - The Dividing Line
Synodus Horrenda - Synodus Horrenda 
Synperium - Elemental Disharmony
Sьngehel - Necromantic Blood
THC 666 - Colossal Incubation
Tanelorn - Burden Divine
Tanin'iver - Dark Evils Desecrate
Tanin'iver - Pyrrhic
TankrusT - The Fast of Solace
Tanvarpmenkv - Goatizm
Taste Hematic Chains - Amigdala
Taxidermist - The Gore You Cant Ignore
Temple of Baal - Verses of Fire
Tercera Prótesis - Serial Killers Music
TerroRaze - Frozen Hell
Terror Sound - Soiled Legacy
Terrordrome - The Day of Sacrilege
Terrordrome - Vehement Convulsion
Terrorist - Mata O Muere
Thanatophagia - Give Me Your Blood, Give Me Your Death
The Amber Will - Clutter
The Antichrist Imperium - Volume III: Satan in His Original Glory
The Biscuit Merchant - Ongaku
The Black Sorcery - Wolven Degrade
The Curse Of Hail - Identical Paths
The Dark Prison Massacre - Deformity of Human Consciousness 畸形人类意识
The Exit Wound - Lonely Path
The Heritance - Focus In Reliquum
The Machete - Regression
The Mask Of Blood - Atrocidad
The Monolith Deathcult - Trivmvirate
The Monolith Deathcult - V2 - Vergelding: Dawn of the Planet of the Ashes
The New Plague - Insatiable (256)
The Parallax - Obliquity of the Ecliptic
The Rigor Mortis - Vaginal Gutting
The Secret Cult of Yog-Sothoth - It Came to Kill Us All
The Seven Gates - Angel of Suffering
The Ugly - Decreation
The Ugly - Thanatology
The Unborn Dead - Primitive Origins
The Unhuman Thorn - Sacro-Kvltus Dementis
Thin - Dusk
Thorns of the Machine - Ripe for the Slaughter
Thorwald - Diablov Tanec
Thou Art Lord - The Regal Pulse Of Lucifer
Thread Of Omen - Palace Of The Fathers
Throcyte - Disaster 
Thron - Thron
Throne ov Shiva - Enchanter ov Serpents 
Throne ov Shiva - The Last Anthem 
Time Of Justice - Инфекция Человеческого Разума
To Descend - Exorcism Of Hope
To Separate the Flesh from the Bones - Utopia Sadistica
To The Grave - Global Warning
Tombthroat - Eden Apocalypse
Torn The Fuck Apart - ...The Dissection of Christ
Torn the Fuck Apart - Kill.Bury.Repeat.
Torture Squad - Esquadrão de Tortura
Torturor - Torturor
Totenmond - Lichtbringer
Totenmond - Reich in Rost
Toxaemia - Where Paths Divide 
Trench Warfare - Hatred Prayer
Tridentifer - Nachtmahr (320)
Trigger Attack - An Human Exist Collapse
Trigonum Mortis - Fall Into the Dark Age
Triumvir Foul - Spiritual Bloodshed
Trocotombix - Psicopompos
Truth Corroded - Worship the Bled
Tsar Bomb - Neowarfare
Turbid North - Under the Eight
Twisted Ending - Hank Fenner
Two Face Sinner - Peccatum Originale 
Tyrann - Shadows of Leng
Uchrony - Deconstruction And Chaos
Ulcer - Rules
Un - The Tomb Of All Things
Unbenign - Unbenign
Unblessed - Unblessed
Uncured - Epidemic
Under Eden - An Aeons-Long Shadow
Undertaker of the Damned - Satanas Potestas Est 
Undivine - Redemption
Ungodly Rest - Delusions of an Indoctrinated Void
Unhinge  - Aggravated Mayhem
Unknown - Unknown
Unsilent - Black Spell Sessions
Urshurark - Pandemonium Theory
Usnea - Random Cosmic Violence
Usurper - Lords of the Permafrost
Usurper - Necronemesis
Usurper - Skeletal Season
VERTIGINOUS - REEK OF PUTREFACTION ON EXCRUCIATING LUST
Vale of Miscreation - Emergence Within the Corridor of Unholy Lacerations
Valkyrja - Throne Ablaze
Valpurga - Fragments Of Immortality
Vanmakt - Ad Luciferi Regnum
Vanum - Ageless Fire
Vastum - Orifical Purge
Veilburner - The Three Lightbearers
Venereal Messiah - Bleeding the Humans
Ventriloquist - За Занавесом Цивилизации
Veritatem Solam - Unholy Protrusions Of Divinity
Violent Opposition - Utopia/Dystopia
Visceral Dissection - Scars of Perversions
Visceral Hatred - Devouring The Parasitic Embryonic Secretions
Visions - Visions
Void Dweller - Night in Hell
Voltumna - Ciclope
Vortex of Clutter - A Praise to Extinction
Vulcano - 1987 Anthropophagy
Vulcano - Wholly Wicked
Vyrion - Vyrion
Warfield - Seven Skins
Warsenal - Barn Burner
Well Of Sacrifice - Primal Conquest
Wetwork - Temple Of Red
With Malice - Hail Kraken
Withdrawn - Skulls of the Weak
Woe of Tyrants - Behold the Lion
Wrathrone - Eve of Infliction 
Wretched Fate - Fleshletting
Xeno - Atlas Construct
Xenoblight - Procreation
Xenosis - Haunted Skies
Xenosis - Of Chaos and Turmoil
Yautja - Songs Of Descent
Zillah - Morta In Crucem
Zmey Gorynich - Mother Russia
Zombie Cookbook - Horroris Causa
Àðêîíà - Ãîé, Ðîäå, Ãîé!
Батюшка - Панихида
Неживой - Пять Башен
Хуй Лопаты - Влажные Истории
兀突骨 - 黄泉ガヘリ
Dead Head - Haatland
Hatestroke - The Schematic Diagram of Hate Distribution
Inferious - Begotten
Zombie Cookbook - Outside The Grave
